"filename", "language", "Python", "JSON", "TOML", "comment", "blank", "total"
"/Users/jacobcoker/Projects/pygame_projects/FF_Endless_Battle/Pipfile", "TOML", 0, 0, 11, 0, 4, 15
"/Users/jacobcoker/Projects/pygame_projects/FF_Endless_Battle/Pipfile.lock", "JSON", 0, 295, 0, 0, 1, 296
"/Users/jacobcoker/Projects/pygame_projects/FF_Endless_Battle/main.py", "Python", 5, 0, 0, 0, 2, 7
"/Users/jacobcoker/Projects/pygame_projects/FF_Endless_Battle/player_data.py", "Python", 443, 0, 0, 0, 2, 445
"/Users/jacobcoker/Projects/pygame_projects/FF_Endless_Battle/settings.py", "Python", 39, 0, 0, 6, 8, 53
"/Users/jacobcoker/Projects/pygame_projects/FF_Endless_Battle/source/game/__init__.py", "Python", 0, 0, 0, 0, 1, 1
"/Users/jacobcoker/Projects/pygame_projects/FF_Endless_Battle/source/game/game.py", "Python", 277, 0, 0, 16, 34, 327
"/Users/jacobcoker/Projects/pygame_projects/FF_Endless_Battle/source/game/load_characters.py", "Python", 137, 0, 0, 124, 5, 266
"/Users/jacobcoker/Projects/pygame_projects/FF_Endless_Battle/source/models/__init__.py", "Python", 0, 0, 0, 0, 1, 1
"/Users/jacobcoker/Projects/pygame_projects/FF_Endless_Battle/source/models/abilities/__init__.py", "Python", 0, 0, 0, 0, 1, 1
"/Users/jacobcoker/Projects/pygame_projects/FF_Endless_Battle/source/models/abilities/abilities.py", "Python", 123, 0, 0, 0, 14, 137
"/Users/jacobcoker/Projects/pygame_projects/FF_Endless_Battle/source/models/character/__init__.py", "Python", 0, 0, 0, 0, 1, 1
"/Users/jacobcoker/Projects/pygame_projects/FF_Endless_Battle/source/models/character/character.py", "Python", 372, 0, 0, 3, 24, 399
"/Users/jacobcoker/Projects/pygame_projects/FF_Endless_Battle/source/models/floating_text/__init__.py", "Python", 0, 0, 0, 0, 1, 1
"/Users/jacobcoker/Projects/pygame_projects/FF_Endless_Battle/source/models/floating_text/damage_text.py", "Python", 107, 0, 0, 0, 13, 120
"/Users/jacobcoker/Projects/pygame_projects/FF_Endless_Battle/source/models/particle/__init__.py", "Python", 0, 0, 0, 0, 1, 1
"/Users/jacobcoker/Projects/pygame_projects/FF_Endless_Battle/source/models/particle/particle.py", "Python", 29, 0, 0, 0, 8, 37
"/Users/jacobcoker/Projects/pygame_projects/FF_Endless_Battle/source/models/sprite_groups/__init__.py", "Python", 0, 0, 0, 0, 1, 1
"/Users/jacobcoker/Projects/pygame_projects/FF_Endless_Battle/source/models/sprite_groups/sprite_groups.py", "Python", 8, 0, 0, 0, 3, 11
"/Users/jacobcoker/Projects/pygame_projects/FF_Endless_Battle/source/models/ui/__init__.py", "Python", 0, 0, 0, 0, 1, 1
"/Users/jacobcoker/Projects/pygame_projects/FF_Endless_Battle/source/models/ui/menu/__init__.py", "Python", 0, 0, 0, 0, 1, 1
"/Users/jacobcoker/Projects/pygame_projects/FF_Endless_Battle/source/models/ui/menu/menu.py", "Python", 242, 0, 0, 1, 21, 264
"/Users/jacobcoker/Projects/pygame_projects/FF_Endless_Battle/source/models/ui/overlay/__init__.py", "Python", 0, 0, 0, 0, 1, 1
"/Users/jacobcoker/Projects/pygame_projects/FF_Endless_Battle/source/models/ui/overlay/draw_target_info.py", "Python", 28, 0, 0, 0, 3, 31
"/Users/jacobcoker/Projects/pygame_projects/FF_Endless_Battle/source/models/ui/overlay/player_action.py", "Python", 48, 0, 0, 0, 6, 54
"/Users/jacobcoker/Projects/pygame_projects/FF_Endless_Battle/source/models/ui/overlay/player_hp.py", "Python", 12, 0, 0, 0, 4, 16
"/Users/jacobcoker/Projects/pygame_projects/FF_Endless_Battle/source/models/ui/overlay/player_turn_indicator.py", "Python", 32, 0, 0, 0, 6, 38
"/Users/jacobcoker/Projects/pygame_projects/FF_Endless_Battle/source/models/ui/overlay/player_turn_list.py", "Python", 31, 0, 0, 0, 4, 35
"/Users/jacobcoker/Projects/pygame_projects/FF_Endless_Battle/source/models/ui/status_bar/__init__.py", "Python", 0, 0, 0, 0, 1, 1
"/Users/jacobcoker/Projects/pygame_projects/FF_Endless_Battle/source/models/ui/status_bar/break_bar.py", "Python", 43, 0, 0, 0, 5, 48
"/Users/jacobcoker/Projects/pygame_projects/FF_Endless_Battle/source/models/ui/status_bar/hp_bar.py", "Python", 58, 0, 0, 0, 5, 63
"/Users/jacobcoker/Projects/pygame_projects/FF_Endless_Battle/source/models/ui/status_bar/mp_bar.py", "Python", 42, 0, 0, 0, 6, 48
"/Users/jacobcoker/Projects/pygame_projects/FF_Endless_Battle/source/screen/__init__.py", "Python", 0, 0, 0, 0, 1, 1
"/Users/jacobcoker/Projects/pygame_projects/FF_Endless_Battle/source/screen/player_detail_screen.py", "Python", 118, 0, 0, 0, 12, 130
"/Users/jacobcoker/Projects/pygame_projects/FF_Endless_Battle/source/util/__init__.py", "Python", 0, 0, 0, 0, 1, 1
"/Users/jacobcoker/Projects/pygame_projects/FF_Endless_Battle/source/util/custom_enum.py", "Python", 31, 0, 0, 0, 8, 39
"/Users/jacobcoker/Projects/pygame_projects/FF_Endless_Battle/source/util/debug.py", "Python", 9, 0, 0, 0, 2, 11
"/Users/jacobcoker/Projects/pygame_projects/FF_Endless_Battle/source/util/util_functions.py", "Python", 75, 0, 0, 0, 11, 86
"Total", "-", 2309, 295, 11, 150, 224, 2989