"filename", "language", "Python", "JSON", "TOML", "comment", "blank", "total"
"/Users/jacobcoker/Projects/pygame_projects/FF_Endless_Battle/Pipfile", "TOML", 0, 0, 11, 0, 4, 15
"/Users/jacobcoker/Projects/pygame_projects/FF_Endless_Battle/Pipfile.lock", "JSON", 0, 295, 0, 0, 1, 296
"/Users/jacobcoker/Projects/pygame_projects/FF_Endless_Battle/main.py", "Python", 5, 0, 0, 0, 1, 6
"/Users/jacobcoker/Projects/pygame_projects/FF_Endless_Battle/player_data.py", "Python", 413, 0, 0, 0, 2, 415
"/Users/jacobcoker/Projects/pygame_projects/FF_Endless_Battle/settings.py", "Python", 25, 0, 0, 1, 3, 29
"/Users/jacobcoker/Projects/pygame_projects/FF_Endless_Battle/source/game/__init__.py", "Python", 0, 0, 0, 0, 1, 1
"/Users/jacobcoker/Projects/pygame_projects/FF_Endless_Battle/source/game/game.py", "Python", 140, 0, 0, 30, 19, 189
"/Users/jacobcoker/Projects/pygame_projects/FF_Endless_Battle/source/game/load_characters.py", "Python", 107, 0, 0, 0, 2, 109
"/Users/jacobcoker/Projects/pygame_projects/FF_Endless_Battle/source/models/__init__.py", "Python", 0, 0, 0, 0, 1, 1
"/Users/jacobcoker/Projects/pygame_projects/FF_Endless_Battle/source/models/abilities/__init__.py", "Python", 0, 0, 0, 0, 1, 1
"/Users/jacobcoker/Projects/pygame_projects/FF_Endless_Battle/source/models/abilities/abilities.py", "Python", 17, 0, 0, 0, 3, 20
"/Users/jacobcoker/Projects/pygame_projects/FF_Endless_Battle/source/models/abilities/ability.py", "Python", 5, 0, 0, 0, 1, 6
"/Users/jacobcoker/Projects/pygame_projects/FF_Endless_Battle/source/models/character/__init__.py", "Python", 0, 0, 0, 0, 1, 1
"/Users/jacobcoker/Projects/pygame_projects/FF_Endless_Battle/source/models/character/character.py", "Python", 325, 0, 0, 17, 24, 366
"/Users/jacobcoker/Projects/pygame_projects/FF_Endless_Battle/source/models/floating_text/__init__.py", "Python", 0, 0, 0, 0, 1, 1
"/Users/jacobcoker/Projects/pygame_projects/FF_Endless_Battle/source/models/floating_text/damage_text.py", "Python", 67, 0, 0, 0, 5, 72
"/Users/jacobcoker/Projects/pygame_projects/FF_Endless_Battle/source/models/particle/__init__.py", "Python", 0, 0, 0, 0, 1, 1
"/Users/jacobcoker/Projects/pygame_projects/FF_Endless_Battle/source/models/particle/particle.py", "Python", 29, 0, 0, 0, 8, 37
"/Users/jacobcoker/Projects/pygame_projects/FF_Endless_Battle/source/models/sprite_groups/__init__.py", "Python", 0, 0, 0, 0, 1, 1
"/Users/jacobcoker/Projects/pygame_projects/FF_Endless_Battle/source/models/sprite_groups/sprite_groups.py", "Python", 8, 0, 0, 0, 3, 11
"/Users/jacobcoker/Projects/pygame_projects/FF_Endless_Battle/source/models/ui/__init__.py", "Python", 0, 0, 0, 0, 1, 1
"/Users/jacobcoker/Projects/pygame_projects/FF_Endless_Battle/source/models/ui/menu/__init__.py", "Python", 0, 0, 0, 0, 1, 1
"/Users/jacobcoker/Projects/pygame_projects/FF_Endless_Battle/source/models/ui/menu/menu.py", "Python", 44, 0, 0, 2, 4, 50
"/Users/jacobcoker/Projects/pygame_projects/FF_Endless_Battle/source/models/ui/status_bar/__init__.py", "Python", 0, 0, 0, 0, 1, 1
"/Users/jacobcoker/Projects/pygame_projects/FF_Endless_Battle/source/models/ui/status_bar/break_bar.py", "Python", 21, 0, 0, 0, 4, 25
"/Users/jacobcoker/Projects/pygame_projects/FF_Endless_Battle/source/models/ui/status_bar/hp_bar.py", "Python", 24, 0, 0, 0, 4, 28
"/Users/jacobcoker/Projects/pygame_projects/FF_Endless_Battle/source/models/ui/status_bar/mp_bar.py", "Python", 20, 0, 0, 0, 4, 24
"/Users/jacobcoker/Projects/pygame_projects/FF_Endless_Battle/source/util/__init__.py", "Python", 0, 0, 0, 0, 1, 1
"/Users/jacobcoker/Projects/pygame_projects/FF_Endless_Battle/source/util/custom_enum.py", "Python", 22, 0, 0, 0, 7, 29
"/Users/jacobcoker/Projects/pygame_projects/FF_Endless_Battle/source/util/debug.py", "Python", 9, 0, 0, 0, 2, 11
"/Users/jacobcoker/Projects/pygame_projects/FF_Endless_Battle/source/util/util_functions.py", "Python", 10, 0, 0, 0, 3, 13
"Total", "-", 1291, 295, 11, 50, 115, 1762